EASY
6;8
d  ;0  ;0  ;0  ;0  ;0  ;0  ;0
d  ;c1 ;0  ;0  ;0  ;0  ;c1 ;d
0  ;0  ;0  ;0  ;0  ;0  ;0  ;0
c1 ;0  ;0  ;0  ;0  ;0  ;0  ;0
b10;0  ;0  ;0  ;0  ;0  ;b10;0
p10;b10;c1 ;0  ;0  ;0  ;d  ;0