EASY
6;8
0  ;b10;b10;b10;b10;b10;b10;0
0  ;0  ;0  ;0  ;b10;  0;0  ;0
d  ;c1 ;d  ;c1 ;d  ;c1 ;p20;0
b10;d  ;c1 ;d  ;c1 ;d  ;c1 ;0
0  ;c1 ;d  ;c1 ;d  ;c1 ;d  ;0
0  ;0  ;0  ;0  ;b10;0  ;0  ;0