EASY
5;7
0  ;0  ;0  ;c1 ;0  ;0  ;d
d  ;0  ;c1 ;p20;0  ;0  ;0
0  ;0  ;0  ;c1 ;0  ;0  ;0
0  ;0  ;0  ;0  ;0  ;0  ;0
0  ;0  ;0  ;d  ;0  ;0  ;0