8;8
0  ;d  ;0  ;0  ;d ;c  ;0  ;0
0  ;c  ;0  ;x  ;x ;x  ;0  ;0
0  ;0  ;0  ;p  ;0 ;0  ;0  ;0
0  ;0  ;0  ;0  ;0 ;0  ;0  ;x
d  ;0  ;c  ;0  ;0 ;0  ;0  ;0
d  ;0  ;c  ;0  ;0 ;0  ;0  ;0
x  ;0  ;0  ;x  ;0 ;c  ;0  ;d
x  ;0  ;0  ;x  ;0 ;c  ;0  ;d