13;7
0 ;0 ;x ;x ;x ;0 ;0
x ;x ;0 ;0 ;0 ;x ;x
x ;d ;d ;0 ;d ;d ;x
x ;d ;0 ;0 ;0 ;d ;x
x ;x ;0 ;0 ;0 ;x ;x
0 ;0 ;x ;0 ;x ;0 ;0
0 ;x ;0 ;0 ;0 ;x ;0
x ;0 ;0 ;0 ;0 ;0 ;x
x ;0 ;c ;0 ;c ;0 ;x
x ;0 ;c ;p ;c ;0 ;x
x ;0 ;c ;0 ;c ;0 ;x
x ;x ;0 ;0 ;0 ;x ;x
0 ;0 ;x ;x ;x ;0 ;0