11;11
x;x;x;x ;x ;x ;x ;x ;x ;x ;x
x;0;0;d ;0 ;d ;0 ;d ;0 ;0 ;x
x;0;d;0 ;d ;0 ;d ;0 ;d ;0 ;x
x;x;x;x ;x ;x ;x ;c ;0 ;0 ;x
x;0;0;0 ;0 ;c ;0 ;c ;0 ;0 ;x
x;0;0;0 ;0 ;0 ;0 ;0 ;x ;0 ;x
x;x;x;c ;x ;x ;x ;x ;0 ;0 ;x
x;p;0;0 ;0 ;c ;0 ;x ;0 ;0 ;x
x;x;x;0 ;c ;0 ;c ;0 ;0 ;0 ;x
0;0;0;x ;x ;0 ;0 ;0 ;0 ;0 ;x
0;0;0;0 ;x ;x ;x ;x ;x ;x ;x
