7;15
0;0;d;d;d;x;0;0;0;0;0;0;0;d;0
0;0;0;0;0;x;c;c;c;0;0;0;0;0;d
x;0;0;c;0;0;0;0;0;0;0;0;0;0;d
d;x;x;0;c;0;c;c;c;x;x;x;x;x;x
d;d;d;x;x;0;0;0;p;x;0;0;0;0;0
0;0;c;0;c;0;c;c;c;0;0;0;0;0;0
0;0;0;0;0;0;0;0;0;x;d;x;d;x;d